Learning order,PL* rounds,PL* MQ resets,PL* MQ input symbols,PL* EQ resets,PL* EQ input symbols,PL* total resets,PL* total input symbols,Non-adaptive rounds,Non-adaptive MQ resets,Non-adaptive MQ input symbols,Non-adaptive EQ resets,Non-adaptive EQ input symbols,Non-adaptive total resets,Non-adaptive total input symbols
[5; 12; 1; 15; 3; 2; 9; 8; 13; 14; 4; 10; 7; 11; 6],17,80100,442791,3868775,25209563,3948875,25652354,30,73937,401613,4355463,28235499,4429400,28637112
[4; 10; 15; 8; 1; 9; 12; 5; 2; 3; 6; 13; 7; 14; 11],18,77449,423977,3762778,24528338,3840227,24952315,30,73937,401613,4355463,28235499,4429400,28637112
[8; 4; 1; 13; 5; 14; 15; 11; 6; 7; 3; 9; 2; 10; 12],17,77420,423941,3752925,24443818,3830345,24867759,30,73937,401613,4355463,28235499,4429400,28637112
[1; 6; 15; 5; 7; 10; 14; 13; 2; 11; 12; 9; 4; 3; 8],17,78786,433826,3815500,24958031,3894286,25391857,30,73937,401613,4355463,28235499,4429400,28637112
[13; 9; 14; 2; 11; 5; 15; 12; 8; 3; 6; 4; 1; 7; 10],16,78116,430159,3672154,23965129,3750270,24395288,30,73937,401613,4355463,28235499,4429400,28637112
[3; 4; 15; 7; 8; 1; 13; 6; 2; 11; 10; 14; 9; 5; 12],19,80584,444100,3837001,24944545,3917585,25388645,30,73937,401613,4355463,28235499,4429400,28637112
[11; 1; 8; 7; 3; 15; 9; 5; 2; 6; 12; 10; 4; 13; 14],18,78379,431309,3813991,24873080,3892370,25304389,30,73937,401613,4355463,28235499,4429400,28637112
[11; 2; 7; 1; 15; 4; 6; 8; 9; 12; 14; 5; 3; 10; 13],18,78240,430178,3794824,24738006,3873064,25168184,30,73937,401613,4355463,28235499,4429400,28637112
[2; 3; 1; 12; 7; 15; 13; 8; 9; 5; 6; 11; 10; 14; 4],20,80950,446428,3937484,25685638,4018434,26132066,30,73937,401613,4355463,28235499,4429400,28637112
[13; 9; 3; 11; 1; 14; 12; 6; 8; 15; 10; 4; 5; 7; 2],17,79217,435321,3794165,24758883,3873382,25194204,30,73937,401613,4355463,28235499,4429400,28637112
[12; 6; 7; 8; 15; 11; 9; 3; 4; 2; 10; 13; 14; 5; 1],20,80441,443379,3788122,24706912,3868563,25150291,30,73937,401613,4355463,28235499,4429400,28637112
[3; 12; 5; 7; 11; 8; 13; 4; 10; 15; 2; 14; 1; 6; 9],19,80879,448945,3860310,25112136,3941189,25561081,30,73937,401613,4355463,28235499,4429400,28637112
[11; 5; 10; 2; 8; 4; 6; 7; 9; 15; 14; 3; 1; 12; 13],17,78315,431053,3741866,24369964,3820181,24801017,30,73937,401613,4355463,28235499,4429400,28637112
[5; 2; 13; 15; 7; 14; 8; 10; 11; 12; 9; 3; 4; 6; 1],15,77175,423624,3613102,23587064,3690277,24010688,30,73937,401613,4355463,28235499,4429400,28637112
[8; 14; 11; 9; 1; 2; 3; 5; 4; 6; 12; 10; 7; 15; 13],18,77574,425818,3840960,25046091,3918534,25471909,30,73937,401613,4355463,28235499,4429400,28637112
[7; 10; 2; 14; 13; 4; 3; 11; 6; 15; 8; 9; 1; 12; 5],16,78253,430784,3684260,24016224,3762513,24447008,30,73937,401613,4355463,28235499,4429400,28637112
[3; 12; 9; 15; 6; 5; 11; 13; 14; 4; 8; 7; 10; 1; 2],19,80879,448945,3824121,24907089,3905000,25356034,30,73937,401613,4355463,28235499,4429400,28637112
[8; 11; 3; 15; 4; 10; 14; 9; 2; 7; 6; 1; 5; 12; 13],18,75761,414415,3759234,24502680,3834995,24917095,30,73937,401613,4355463,28235499,4429400,28637112
[6; 4; 9; 8; 10; 7; 15; 5; 1; 14; 2; 3; 12; 13; 11],18,79706,440184,3812719,24858923,3892425,25299107,30,73937,401613,4355463,28235499,4429400,28637112
[15; 2; 6; 7; 3; 12; 1; 8; 11; 10; 4; 14; 5; 9; 13],20,78735,432360,3709976,24211360,3788711,24643720,30,73937,401613,4355463,28235499,4429400,28637112
[11; 8; 13; 14; 1; 10; 5; 12; 3; 15; 2; 4; 6; 7; 9],18,76369,418432,3760820,24515736,3837189,24934168,30,73937,401613,4355463,28235499,4429400,28637112
[1; 5; 13; 2; 6; 9; 14; 12; 4; 15; 3; 8; 7; 10; 11],17,78782,432640,3579536,23385507,3658318,23818147,30,73937,401613,4355463,28235499,4429400,28637112
[15; 3; 4; 2; 13; 6; 10; 5; 11; 9; 7; 8; 1; 12; 14],19,80109,441028,3938283,25683069,4018392,26124097,30,73937,401613,4355463,28235499,4429400,28637112
[9; 2; 14; 13; 11; 1; 10; 15; 8; 7; 5; 12; 4; 3; 6],16,77674,426744,3647432,23852905,3725106,24279649,30,73937,401613,4355463,28235499,4429400,28637112
[6; 15; 7; 5; 13; 4; 2; 1; 8; 14; 3; 9; 11; 10; 12],18,79546,438816,3759350,24553854,3838896,24992670,30,73937,401613,4355463,28235499,4429400,28637112
[10; 13; 3; 7; 4; 6; 14; 12; 11; 8; 2; 5; 1; 9; 15],19,79535,437547,3878615,25260773,3958150,25698320,30,73937,401613,4355463,28235499,4429400,28637112
[6; 13; 11; 15; 14; 5; 1; 10; 8; 7; 4; 9; 12; 2; 3],17,78620,435015,3798531,24790800,3877151,25225815,30,73937,401613,4355463,28235499,4429400,28637112
[8; 10; 14; 11; 6; 15; 4; 9; 2; 3; 5; 7; 1; 12; 13],20,78582,431281,3777581,24593555,3856163,25024836,30,73937,401613,4355463,28235499,4429400,28637112
[8; 2; 1; 6; 15; 13; 9; 12; 3; 14; 11; 10; 5; 4; 7],20,80464,443300,3795320,24730531,3875784,25173831,30,73937,401613,4355463,28235499,4429400,28637112
[10; 15; 5; 2; 14; 1; 13; 3; 8; 12; 7; 9; 4; 6; 11],16,75988,416150,3662115,23933478,3738103,24349628,30,73937,401613,4355463,28235499,4429400,28637112
[3; 6; 15; 1; 8; 2; 12; 10; 4; 7; 13; 14; 11; 5; 9],19,80160,441376,3835760,24985573,3915920,25426949,30,73937,401613,4355463,28235499,4429400,28637112
[9; 11; 6; 7; 12; 3; 14; 13; 8; 4; 2; 5; 1; 10; 15],18,80066,440704,3750503,24443654,3830569,24884358,30,73937,401613,4355463,28235499,4429400,28637112
[15; 5; 10; 3; 4; 11; 9; 1; 14; 12; 8; 2; 7; 13; 6],17,78013,427759,3926822,25633165,4004835,26060924,30,73937,401613,4355463,28235499,4429400,28637112
[14; 9; 6; 11; 7; 13; 1; 5; 12; 3; 8; 4; 10; 15; 2],20,79321,436044,3845033,25098365,3924354,25534409,30,73937,401613,4355463,28235499,4429400,28637112
[7; 2; 6; 9; 3; 4; 12; 8; 15; 5; 10; 11; 14; 1; 13],18,77649,426818,3695704,24147536,3773353,24574354,30,73937,401613,4355463,28235499,4429400,28637112
[4; 9; 8; 12; 10; 2; 7; 11; 5; 15; 13; 3; 14; 1; 6],18,77375,424294,3783774,24695783,3861149,25120077,30,73937,401613,4355463,28235499,4429400,28637112
[7; 9; 2; 6; 12; 1; 15; 8; 14; 10; 4; 11; 5; 13; 3],18,78490,430692,3710109,24239195,3788599,24669887,30,73937,401613,4355463,28235499,4429400,28637112
[3; 7; 15; 13; 2; 5; 14; 10; 9; 11; 1; 4; 12; 8; 6],19,81079,447291,3867103,25134113,3948182,25581404,30,73937,401613,4355463,28235499,4429400,28637112
[1; 9; 7; 14; 3; 4; 13; 10; 15; 12; 6; 11; 2; 5; 8],20,79999,440421,3732000,24354184,3811999,24794605,30,73937,401613,4355463,28235499,4429400,28637112
[10; 9; 12; 11; 13; 14; 5; 6; 2; 4; 3; 8; 15; 1; 7],18,78501,432186,3742971,24408138,3821472,24840324,30,73937,401613,4355463,28235499,4429400,28637112
[7; 11; 14; 2; 13; 6; 3; 8; 5; 1; 15; 9; 12; 10; 4],18,79117,436076,3839661,24996371,3918778,25432447,30,73937,401613,4355463,28235499,4429400,28637112
[7; 14; 5; 15; 11; 10; 9; 3; 6; 8; 13; 2; 1; 4; 12],16,77961,430292,3704169,24169841,3782130,24600133,30,73937,401613,4355463,28235499,4429400,28637112
[2; 6; 15; 10; 4; 7; 13; 12; 5; 1; 3; 8; 11; 14; 9],18,78191,430318,3697163,24110626,3775354,24540944,30,73937,401613,4355463,28235499,4429400,28637112
[6; 2; 11; 8; 14; 13; 3; 1; 15; 7; 12; 4; 9; 5; 10],20,79793,439160,3823839,24913959,3903632,25353119,30,73937,401613,4355463,28235499,4429400,28637112
[7; 10; 4; 8; 9; 2; 12; 5; 13; 15; 14; 11; 6; 1; 3],18,78159,429950,3826068,24940975,3904227,25370925,30,73937,401613,4355463,28235499,4429400,28637112
[10; 7; 8; 15; 1; 9; 5; 2; 11; 12; 3; 13; 6; 14; 4],18,78152,429665,3814533,24898381,3892685,25328046,30,73937,401613,4355463,28235499,4429400,28637112
[1; 5; 2; 9; 3; 6; 11; 15; 4; 14; 13; 7; 8; 10; 12],15,78351,433110,3642695,23803703,3721046,24236813,30,73937,401613,4355463,28235499,4429400,28637112
[6; 8; 1; 11; 15; 13; 5; 4; 14; 7; 9; 3; 12; 10; 2],19,78533,432764,3792293,24745358,3870826,25178122,30,73937,401613,4355463,28235499,4429400,28637112
[8; 11; 6; 14; 10; 3; 4; 7; 9; 5; 1; 15; 12; 2; 13],19,78690,432004,3737501,24404766,3816191,24836770,30,73937,401613,4355463,28235499,4429400,28637112
[1; 12; 14; 4; 15; 6; 10; 5; 11; 2; 13; 9; 7; 8; 3],18,79917,441356,3676959,24002581,3756876,24443937,30,73937,401613,4355463,28235499,4429400,28637112
[14; 13; 2; 3; 6; 8; 12; 4; 11; 5; 9; 15; 7; 10; 1],17,77508,427778,3709520,24198129,3787028,24625907,30,73937,401613,4355463,28235499,4429400,28637112
[14; 12; 7; 1; 8; 10; 13; 15; 2; 4; 9; 6; 5; 3; 11],18,78669,432839,3780419,24598926,3859088,25031765,30,73937,401613,4355463,28235499,4429400,28637112
[1; 12; 10; 4; 7; 5; 2; 8; 13; 9; 11; 14; 15; 3; 6],18,79405,437857,3766039,24565399,3845444,25003256,30,73937,401613,4355463,28235499,4429400,28637112
[12; 11; 15; 9; 7; 6; 14; 5; 3; 10; 13; 1; 2; 4; 8],18,79157,436463,3673712,23942465,3752869,24378928,30,73937,401613,4355463,28235499,4429400,28637112
[12; 10; 15; 13; 1; 7; 6; 8; 5; 2; 9; 14; 11; 4; 3],16,79476,438746,3682816,24051203,3762292,24489949,30,73937,401613,4355463,28235499,4429400,28637112
[12; 15; 3; 8; 10; 6; 5; 1; 2; 4; 13; 7; 9; 14; 11],20,80922,446261,3721651,24333224,3802573,24779485,30,73937,401613,4355463,28235499,4429400,28637112
[13; 7; 12; 11; 9; 3; 5; 6; 4; 8; 2; 15; 10; 14; 1],18,79120,436295,3776674,24625677,3855794,25061972,30,73937,401613,4355463,28235499,4429400,28637112
[14; 8; 5; 2; 7; 4; 1; 10; 3; 12; 9; 15; 13; 11; 6],17,78508,430805,3775949,24608473,3854457,25039278,30,73937,401613,4355463,28235499,4429400,28637112
[13; 8; 4; 11; 6; 14; 1; 10; 7; 5; 2; 15; 3; 12; 9],18,76916,420689,3780878,24619001,3857794,25039690,30,73937,401613,4355463,28235499,4429400,28637112
[2; 14; 5; 15; 9; 13; 6; 4; 10; 11; 7; 8; 12; 3; 1],16,78353,429938,3661906,23877784,3740259,24307722,30,73937,401613,4355463,28235499,4429400,28637112
[10; 9; 4; 3; 6; 7; 12; 5; 11; 2; 13; 15; 14; 8; 1],17,76851,421530,3907378,25500983,3984229,25922513,30,73937,401613,4355463,28235499,4429400,28637112
[4; 13; 7; 6; 8; 12; 1; 10; 11; 2; 3; 5; 15; 14; 9],20,79780,438911,3881212,25316635,3960992,25755546,30,73937,401613,4355463,28235499,4429400,28637112
[8; 2; 3; 12; 13; 11; 9; 15; 6; 1; 7; 5; 14; 10; 4],19,77583,426121,3836387,24971638,3913970,25397759,30,73937,401613,4355463,28235499,4429400,28637112
[1; 10; 12; 2; 15; 14; 13; 8; 7; 4; 5; 3; 11; 9; 6],16,77779,429208,3633066,23709480,3710845,24138688,30,73937,401613,4355463,28235499,4429400,28637112
[3; 13; 1; 4; 10; 14; 12; 2; 8; 5; 6; 9; 7; 11; 15],19,80207,443992,3827287,24897225,3907494,25341217,30,73937,401613,4355463,28235499,4429400,28637112
[4; 9; 12; 2; 15; 13; 10; 5; 14; 8; 7; 3; 1; 11; 6],18,77985,427347,3766585,24489126,3844570,24916473,30,73937,401613,4355463,28235499,4429400,28637112
[14; 13; 3; 15; 5; 11; 1; 8; 12; 10; 9; 6; 7; 4; 2],19,79017,435908,3847767,25044488,3926784,25480396,30,73937,401613,4355463,28235499,4429400,28637112
[7; 8; 4; 15; 1; 3; 5; 11; 9; 10; 2; 6; 12; 14; 13],18,78771,434114,3646805,23791008,3725576,24225122,30,73937,401613,4355463,28235499,4429400,28637112
[13; 11; 2; 5; 1; 12; 10; 14; 7; 6; 15; 9; 3; 8; 4],18,78303,430815,3747153,24479030,3825456,24909845,30,73937,401613,4355463,28235499,4429400,28637112
[5; 3; 9; 14; 2; 1; 4; 13; 12; 15; 11; 6; 8; 7; 10],19,78722,432123,3870902,25178021,3949624,25610144,30,73937,401613,4355463,28235499,4429400,28637112
[14; 4; 3; 10; 15; 1; 12; 6; 8; 2; 13; 5; 11; 9; 7],19,79619,437892,3802502,24771655,3882121,25209547,30,73937,401613,4355463,28235499,4429400,28637112
[8; 6; 3; 2; 9; 15; 12; 13; 5; 14; 1; 10; 11; 4; 7],19,80184,441481,3707339,24165028,3787523,24606509,30,73937,401613,4355463,28235499,4429400,28637112
[7; 5; 3; 8; 14; 1; 4; 6; 2; 15; 11; 10; 9; 13; 12],18,80205,444674,3780116,24617459,3860321,25062133,30,73937,401613,4355463,28235499,4429400,28637112
[9; 14; 12; 10; 11; 8; 4; 15; 1; 3; 7; 13; 5; 6; 2],18,78022,428776,3738982,24332836,3817004,24761612,30,73937,401613,4355463,28235499,4429400,28637112
[6; 7; 12; 1; 11; 10; 13; 5; 2; 4; 14; 9; 3; 15; 8],20,80305,442461,3849588,25110329,3929893,25552790,30,73937,401613,4355463,28235499,4429400,28637112
[5; 9; 6; 10; 7; 8; 1; 4; 12; 13; 2; 15; 11; 3; 14],17,79010,434097,3694819,24131793,3773829,24565890,30,73937,401613,4355463,28235499,4429400,28637112
[10; 13; 9; 2; 3; 11; 14; 1; 4; 7; 5; 6; 8; 15; 12],16,79089,434728,3655328,23870776,3734417,24305504,30,73937,401613,4355463,28235499,4429400,28637112
[10; 4; 2; 1; 7; 3; 15; 14; 12; 8; 6; 11; 13; 9; 5],18,79659,439773,3752240,24449903,3831899,24889676,30,73937,401613,4355463,28235499,4429400,28637112
[8; 9; 15; 7; 3; 10; 4; 2; 14; 1; 11; 5; 6; 13; 12],18,78024,428770,3786439,24675332,3864463,25104102,30,73937,401613,4355463,28235499,4429400,28637112
[3; 4; 11; 9; 8; 10; 7; 13; 6; 15; 2; 14; 1; 5; 12],19,79597,439476,3807669,24795865,3887266,25235341,30,73937,401613,4355463,28235499,4429400,28637112
[4; 2; 6; 5; 7; 13; 14; 11; 12; 15; 10; 1; 8; 3; 9],18,79511,438693,3772734,24595692,3852245,25034385,30,73937,401613,4355463,28235499,4429400,28637112
[15; 10; 7; 8; 9; 12; 4; 2; 1; 11; 5; 3; 13; 14; 6],16,77365,424314,3672808,23977367,3750173,24401681,30,73937,401613,4355463,28235499,4429400,28637112
[9; 1; 2; 8; 10; 7; 6; 14; 15; 4; 11; 5; 12; 3; 13],18,78508,432257,3691011,24083402,3769519,24515659,30,73937,401613,4355463,28235499,4429400,28637112
[13; 3; 7; 5; 2; 4; 11; 14; 9; 8; 10; 6; 1; 15; 12],19,80307,442419,3853611,25093487,3933918,25535906,30,73937,401613,4355463,28235499,4429400,28637112
[8; 12; 3; 7; 13; 5; 14; 11; 10; 6; 9; 1; 2; 4; 15],19,77839,428028,3708673,24160595,3786512,24588623,30,73937,401613,4355463,28235499,4429400,28637112
[6; 2; 10; 8; 4; 9; 11; 1; 13; 7; 14; 12; 5; 15; 3],18,79787,440434,3792893,24712911,3872680,25153345,30,73937,401613,4355463,28235499,4429400,28637112
[14; 7; 5; 2; 4; 11; 9; 12; 1; 3; 6; 15; 8; 10; 13],16,79527,437569,3639571,23742631,3719098,24180200,30,73937,401613,4355463,28235499,4429400,28637112
[15; 14; 6; 3; 13; 5; 8; 4; 2; 12; 7; 10; 1; 9; 11],19,77827,426629,3646735,23828440,3724562,24255069,30,73937,401613,4355463,28235499,4429400,28637112
[14; 6; 5; 9; 12; 15; 2; 10; 8; 3; 11; 7; 4; 13; 1],17,79760,440495,3812967,24894850,3892727,25335345,30,73937,401613,4355463,28235499,4429400,28637112
[13; 8; 14; 10; 2; 5; 11; 9; 4; 6; 3; 15; 12; 7; 1],18,77400,424799,3761573,24514714,3838973,24939513,30,73937,401613,4355463,28235499,4429400,28637112
[8; 5; 4; 2; 12; 14; 13; 11; 3; 9; 15; 6; 10; 1; 7],17,77712,426767,3728585,24344825,3806297,24771592,30,73937,401613,4355463,28235499,4429400,28637112
[14; 10; 5; 4; 15; 9; 13; 2; 3; 1; 11; 8; 7; 6; 12],17,78101,429361,3722105,24261875,3800206,24691236,30,73937,401613,4355463,28235499,4429400,28637112
[5; 11; 1; 3; 15; 9; 12; 6; 13; 7; 14; 4; 10; 2; 8],18,76037,416543,3770406,24609942,3846443,25026485,30,73937,401613,4355463,28235499,4429400,28637112
[14; 12; 9; 8; 7; 3; 13; 6; 11; 1; 2; 4; 15; 10; 5],18,79599,439298,3811682,24834348,3891281,25273646,30,73937,401613,4355463,28235499,4429400,28637112
[14; 11; 3; 10; 12; 8; 5; 6; 7; 15; 1; 13; 2; 9; 4],18,77059,423035,3727685,24370456,3804744,24793491,30,73937,401613,4355463,28235499,4429400,28637112
[2; 13; 4; 5; 8; 1; 7; 6; 15; 14; 10; 9; 3; 11; 12],18,78480,430667,3770237,24565151,3848717,24995818,30,73937,401613,4355463,28235499,4429400,28637112
[6; 5; 4; 1; 2; 10; 7; 3; 13; 15; 14; 12; 9; 11; 8],17,79127,436228,3758126,24494357,3837253,24930585,30,73937,401613,4355463,28235499,4429400,28637112
[14; 2; 6; 7; 1; 3; 12; 8; 11; 10; 4; 5; 9; 15; 13],20,79200,435323,3671537,23985397,3750737,24420720,30,73937,401613,4355463,28235499,4429400,28637112
[14; 3; 13; 2; 11; 12; 7; 1; 5; 4; 8; 15; 6; 9; 10],19,80786,445420,3940700,25690500,4021486,26135920,30,73937,401613,4355463,28235499,4429400,28637112
[5; 8; 10; 14; 12; 11; 15; 6; 2; 9; 3; 4; 13; 1; 7],19,77263,422997,3817243,24904272,3894506,25327269,30,73937,401613,4355463,28235499,4429400,28637112
[9; 15; 3; 11; 7; 1; 10; 5; 13; 8; 2; 14; 4; 6; 12],17,79007,435803,3684933,24076844,3763940,24512647,30,73937,401613,4355463,28235499,4429400,28637112
[6; 9; 4; 14; 3; 5; 7; 13; 10; 15; 11; 2; 12; 1; 8],17,78962,433838,3766775,24541981,3845737,24975819,30,73937,401613,4355463,28235499,4429400,28637112
[12; 13; 5; 9; 8; 15; 2; 10; 6; 4; 7; 14; 11; 1; 3],18,78398,430183,3763133,24568798,3841531,24998981,30,73937,401613,4355463,28235499,4429400,28637112
[15; 1; 7; 2; 14; 4; 13; 8; 10; 6; 11; 9; 5; 12; 3],18,78968,435301,3707149,24185200,3786117,24620501,30,73937,401613,4355463,28235499,4429400,28637112
[15; 14; 3; 6; 13; 12; 9; 5; 4; 8; 1; 10; 11; 7; 2],19,79697,440603,3655914,23922817,3735611,24363420,30,73937,401613,4355463,28235499,4429400,28637112
[12; 13; 14; 2; 15; 10; 6; 11; 1; 9; 8; 3; 7; 5; 4],18,78461,431740,3667441,23945445,3745902,24377185,30,73937,401613,4355463,28235499,4429400,28637112
[6; 2; 7; 3; 1; 12; 9; 4; 15; 5; 14; 11; 10; 13; 8],20,79793,439160,3831525,25022289,3911318,25461449,30,73937,401613,4355463,28235499,4429400,28637112
[3; 2; 12; 8; 11; 10; 5; 7; 13; 4; 15; 9; 1; 14; 6],19,81079,447291,3864282,25140315,3945361,25587606,30,73937,401613,4355463,28235499,4429400,28637112
[1; 7; 3; 13; 12; 14; 4; 6; 9; 8; 10; 5; 11; 2; 15],20,80924,446230,3880766,25332290,3961690,25778520,30,73937,401613,4355463,28235499,4429400,28637112
[14; 2; 15; 1; 6; 9; 3; 4; 8; 12; 5; 13; 11; 7; 10],20,78922,433539,3726997,24336134,3805919,24769673,30,73937,401613,4355463,28235499,4429400,28637112
[11; 13; 4; 5; 2; 9; 3; 14; 7; 12; 15; 1; 8; 6; 10],17,78762,434393,3765588,24609255,3844350,25043648,30,73937,401613,4355463,28235499,4429400,28637112
[7; 11; 14; 6; 15; 13; 1; 8; 2; 10; 5; 3; 4; 12; 9],18,79117,436076,3833093,24958443,3912210,25394519,30,73937,401613,4355463,28235499,4429400,28637112
[12; 13; 10; 4; 2; 14; 15; 6; 3; 11; 8; 9; 5; 1; 7],18,79807,440469,3731588,24340579,3811395,24781048,30,73937,401613,4355463,28235499,4429400,28637112
[12; 10; 3; 6; 9; 5; 4; 11; 15; 1; 14; 8; 13; 2; 7],20,79929,439826,3805175,24762408,3885104,25202234,30,73937,401613,4355463,28235499,4429400,28637112
[5; 6; 7; 3; 11; 9; 8; 1; 12; 10; 4; 15; 13; 14; 2],17,79483,438826,3635389,23770076,3714872,24208902,30,73937,401613,4355463,28235499,4429400,28637112
[4; 10; 5; 13; 12; 6; 14; 3; 1; 7; 15; 11; 8; 2; 9],19,79222,435523,3796709,24751854,3875931,25187377,30,73937,401613,4355463,28235499,4429400,28637112
[13; 14; 1; 9; 8; 3; 5; 7; 4; 12; 11; 2; 6; 10; 15],17,77238,424145,3728726,24285595,3805964,24709740,30,73937,401613,4355463,28235499,4429400,28637112
[7; 12; 5; 10; 6; 8; 4; 11; 14; 1; 13; 15; 3; 2; 9],18,79429,436907,3796872,24774834,3876301,25211741,30,73937,401613,4355463,28235499,4429400,28637112
[11; 3; 7; 2; 5; 6; 9; 12; 14; 8; 4; 15; 10; 1; 13],18,77352,424904,3714571,24210758,3791923,24635662,30,73937,401613,4355463,28235499,4429400,28637112
[6; 12; 4; 8; 7; 15; 11; 2; 13; 10; 3; 5; 9; 1; 14],18,80683,446451,3856254,25154889,3936937,25601340,30,73937,401613,4355463,28235499,4429400,28637112
[15; 7; 6; 10; 13; 2; 9; 4; 5; 3; 8; 1; 14; 11; 12],16,78708,435147,3672099,23999692,3750807,24434839,30,73937,401613,4355463,28235499,4429400,28637112
[11; 12; 14; 2; 5; 1; 13; 8; 9; 4; 7; 6; 10; 3; 15],18,78272,430323,3734607,24355750,3812879,24786073,30,73937,401613,4355463,28235499,4429400,28637112
[8; 7; 14; 13; 3; 4; 1; 15; 5; 9; 2; 12; 11; 10; 6],18,79394,438028,3829969,24929305,3909363,25367333,30,73937,401613,4355463,28235499,4429400,28637112
[8; 7; 12; 1; 2; 10; 13; 9; 4; 11; 6; 5; 15; 3; 14],18,78334,429672,3784821,24662690,3863155,25092362,30,73937,401613,4355463,28235499,4429400,28637112
[4; 2; 8; 13; 10; 1; 15; 3; 11; 12; 7; 9; 6; 14; 5],18,78483,431644,3775176,24636461,3853659,25068105,30,73937,401613,4355463,28235499,4429400,28637112
[7; 6; 12; 11; 1; 5; 10; 3; 13; 14; 9; 15; 2; 8; 4],20,80068,440927,3785696,24701489,3865764,25142416,30,73937,401613,4355463,28235499,4429400,28637112
[9; 12; 11; 2; 13; 6; 8; 7; 5; 10; 3; 4; 14; 15; 1],18,77582,425776,3684712,24074821,3762294,24500597,30,73937,401613,4355463,28235499,4429400,28637112
[4; 12; 15; 8; 11; 2; 10; 9; 13; 6; 1; 14; 3; 7; 5],18,77873,427498,3705924,24164255,3783797,24591753,30,73937,401613,4355463,28235499,4429400,28637112
[3; 10; 6; 5; 7; 8; 1; 12; 11; 2; 15; 9; 13; 4; 14],19,80110,443267,3834300,24971224,3914410,25414491,30,73937,401613,4355463,28235499,4429400,28637112
[7; 6; 13; 11; 2; 5; 3; 10; 1; 12; 9; 8; 14; 15; 4],18,80632,446263,3800286,24840433,3880918,25286696,30,73937,401613,4355463,28235499,4429400,28637112
[15; 3; 8; 5; 7; 4; 1; 6; 10; 13; 11; 14; 9; 12; 2],19,79819,439256,3722835,24286304,3802654,24725560,30,73937,401613,4355463,28235499,4429400,28637112
[12; 6; 14; 11; 5; 4; 15; 1; 2; 9; 3; 7; 10; 8; 13],20,80441,443379,3792555,24733298,3872996,25176677,30,73937,401613,4355463,28235499,4429400,28637112
[1; 5; 9; 2; 10; 15; 7; 13; 6; 3; 12; 11; 14; 8; 4],15,76272,417697,3638418,23788885,3714690,24206582,30,73937,401613,4355463,28235499,4429400,28637112
[9; 8; 13; 11; 3; 6; 10; 1; 7; 2; 5; 4; 15; 12; 14],17,77192,423790,3786251,24698643,3863443,25122433,30,73937,401613,4355463,28235499,4429400,28637112
[5; 14; 7; 6; 4; 13; 12; 9; 3; 2; 11; 15; 8; 10; 1],17,79417,438402,3723652,24290793,3803069,24729195,30,73937,401613,4355463,28235499,4429400,28637112
[5; 14; 11; 9; 1; 7; 10; 13; 3; 15; 8; 4; 2; 12; 6],17,78185,430345,3767966,24590328,3846151,25020673,30,73937,401613,4355463,28235499,4429400,28637112
[4; 11; 3; 7; 2; 13; 8; 12; 5; 15; 9; 1; 10; 14; 6],17,79605,437888,3737552,24329864,3817157,24767752,30,73937,401613,4355463,28235499,4429400,28637112
[10; 15; 5; 12; 3; 2; 7; 4; 8; 6; 14; 11; 9; 13; 1],17,79312,436136,3908949,25453563,3988261,25889699,30,73937,401613,4355463,28235499,4429400,28637112
[7; 8; 1; 5; 4; 2; 9; 12; 3; 15; 10; 6; 11; 13; 14],18,80096,441280,3675339,23955634,3755435,24396914,30,73937,401613,4355463,28235499,4429400,28637112
[9; 8; 11; 7; 13; 5; 6; 2; 3; 1; 14; 12; 4; 10; 15],18,78755,432414,3818108,24837507,3896863,25269921,30,73937,401613,4355463,28235499,4429400,28637112
[7; 4; 2; 13; 5; 12; 10; 9; 15; 14; 8; 6; 3; 11; 1],18,79742,438897,3685523,24046828,3765265,24485725,30,73937,401613,4355463,28235499,4429400,28637112
[3; 1; 2; 11; 13; 4; 10; 9; 14; 15; 6; 12; 8; 5; 7],19,80979,446640,3857221,25097711,3938200,25544351,30,73937,401613,4355463,28235499,4429400,28637112
[14; 8; 3; 12; 6; 9; 10; 11; 13; 15; 4; 2; 7; 5; 1],18,77252,424253,3800830,24778724,3878082,25202977,30,73937,401613,4355463,28235499,4429400,28637112
[13; 6; 10; 3; 4; 12; 2; 5; 9; 7; 8; 1; 14; 11; 15],17,78747,436047,3746780,24477720,3825527,24913767,30,73937,401613,4355463,28235499,4429400,28637112
[5; 12; 6; 14; 13; 1; 10; 7; 3; 11; 9; 8; 2; 15; 4],17,80036,442303,3645605,23788049,3725641,24230352,30,73937,401613,4355463,28235499,4429400,28637112
[5; 9; 4; 2; 13; 14; 8; 11; 3; 6; 7; 15; 1; 12; 10],15,77014,424029,3665417,23955810,3742431,24379839,30,73937,401613,4355463,28235499,4429400,28637112
[13; 1; 7; 12; 10; 14; 15; 3; 6; 2; 5; 8; 9; 11; 4],16,79570,437592,3635219,23789377,3714789,24226969,30,73937,401613,4355463,28235499,4429400,28637112
[12; 2; 9; 14; 7; 8; 5; 13; 10; 6; 3; 4; 15; 1; 11],18,77263,423756,3673596,23947065,3750859,24370821,30,73937,401613,4355463,28235499,4429400,28637112
[15; 12; 2; 7; 10; 5; 3; 1; 13; 14; 11; 6; 8; 9; 4],16,78908,434957,3614322,23598041,3693230,24032998,30,73937,401613,4355463,28235499,4429400,28637112
[2; 13; 10; 12; 15; 7; 5; 3; 14; 11; 6; 8; 4; 9; 1],16,78059,429349,3652313,23895274,3730372,24324623,30,73937,401613,4355463,28235499,4429400,28637112
[9; 13; 7; 5; 14; 2; 6; 15; 8; 12; 4; 1; 10; 3; 11],16,76871,422836,3686074,24033657,3762945,24456493,30,73937,401613,4355463,28235499,4429400,28637112
[10; 3; 13; 12; 5; 15; 9; 2; 6; 14; 8; 4; 1; 11; 7],19,80114,441201,3830544,24923255,3910658,25364456,30,73937,401613,4355463,28235499,4429400,28637112
[7; 5; 8; 2; 14; 12; 13; 15; 10; 1; 11; 6; 9; 3; 4],18,78096,428293,3776943,24608193,3855039,25036486,30,73937,401613,4355463,28235499,4429400,28637112
[10; 8; 15; 4; 2; 13; 7; 11; 6; 12; 3; 9; 5; 14; 1],18,77606,425126,3791326,24648173,3868932,25073299,30,73937,401613,4355463,28235499,4429400,28637112
[6; 15; 8; 10; 13; 1; 5; 2; 11; 12; 4; 7; 9; 14; 3],19,78513,433018,3793672,24763665,3872185,25196683,30,73937,401613,4355463,28235499,4429400,28637112
[3; 10; 2; 12; 1; 14; 9; 8; 11; 15; 5; 6; 13; 7; 4],19,80886,446073,3827869,24886064,3908755,25332137,30,73937,401613,4355463,28235499,4429400,28637112
[11; 2; 8; 5; 9; 1; 7; 13; 12; 6; 3; 14; 15; 10; 4],18,78751,433865,3762108,24540162,3840859,24974027,30,73937,401613,4355463,28235499,4429400,28637112
[9; 15; 3; 13; 1; 6; 8; 11; 14; 4; 5; 7; 12; 2; 10],17,75755,414818,3685609,24103568,3761364,24518386,30,73937,401613,4355463,28235499,4429400,28637112
[13; 10; 14; 7; 3; 2; 12; 4; 15; 5; 8; 11; 1; 6; 9],18,77859,428116,3975422,25953106,4053281,26381222,30,73937,401613,4355463,28235499,4429400,28637112
[6; 13; 9; 4; 8; 10; 14; 3; 15; 1; 2; 5; 12; 7; 11],17,78231,430280,3732346,24409687,3810577,24839967,30,73937,401613,4355463,28235499,4429400,28637112
[12; 11; 3; 15; 1; 13; 4; 10; 8; 5; 7; 2; 9; 6; 14],19,78144,429949,3816457,24874423,3894601,25304372,30,73937,401613,4355463,28235499,4429400,28637112
[8; 11; 7; 10; 13; 1; 12; 5; 6; 14; 9; 2; 3; 15; 4],18,78479,430706,3749401,24486281,3827880,24916987,30,73937,401613,4355463,28235499,4429400,28637112
[14; 15; 12; 6; 10; 9; 4; 5; 11; 2; 8; 13; 7; 1; 3],18,80046,441879,3678461,24037143,3758507,24479022,30,73937,401613,4355463,28235499,4429400,28637112
[1; 4; 7; 15; 3; 10; 9; 5; 6; 11; 8; 14; 2; 13; 12],18,80602,444199,3657322,23854213,3737924,24298412,30,73937,401613,4355463,28235499,4429400,28637112
[8; 14; 6; 5; 12; 2; 1; 9; 10; 15; 11; 3; 13; 4; 7],19,80297,442243,3748439,24422540,3828736,24864783,30,73937,401613,4355463,28235499,4429400,28637112
[13; 5; 14; 3; 1; 7; 9; 12; 6; 11; 2; 4; 15; 8; 10],19,78236,429100,3809774,24803092,3888010,25232192,30,73937,401613,4355463,28235499,4429400,28637112
[4; 11; 2; 8; 12; 14; 15; 6; 9; 3; 13; 7; 5; 10; 1],18,77568,425576,3775129,24588009,3852697,25013585,30,73937,401613,4355463,28235499,4429400,28637112
[10; 2; 7; 5; 1; 13; 11; 4; 15; 3; 9; 8; 12; 6; 14],16,77674,428264,3742413,24432911,3820087,24861175,30,73937,401613,4355463,28235499,4429400,28637112
[8; 7; 1; 14; 13; 3; 6; 12; 10; 4; 2; 15; 9; 5; 11],18,79394,438027,3830365,24925309,3909759,25363336,30,73937,401613,4355463,28235499,4429400,28637112
[5; 3; 14; 6; 1; 15; 4; 9; 12; 8; 2; 13; 10; 7; 11],19,78802,432743,3866432,25147567,3945234,25580310,30,73937,401613,4355463,28235499,4429400,28637112
[12; 5; 11; 6; 9; 14; 4; 3; 1; 7; 15; 13; 10; 2; 8],20,79163,435032,3718650,24270350,3797813,24705382,30,73937,401613,4355463,28235499,4429400,28637112
[10; 4; 3; 6; 12; 13; 9; 7; 1; 2; 14; 11; 5; 15; 8],19,78944,435757,3670741,23935261,3749685,24371018,30,73937,401613,4355463,28235499,4429400,28637112
[6; 3; 5; 8; 9; 7; 12; 15; 4; 11; 13; 2; 1; 14; 10],19,78849,435021,3795156,24759870,3874005,25194891,30,73937,401613,4355463,28235499,4429400,28637112
[15; 4; 11; 10; 13; 9; 1; 2; 6; 14; 8; 12; 5; 3; 7],18,79108,434904,3752293,24471049,3831401,24905953,30,73937,401613,4355463,28235499,4429400,28637112
[14; 13; 5; 3; 6; 10; 11; 12; 15; 1; 8; 4; 2; 9; 7],19,78320,429856,3855173,25078969,3933493,25508825,30,73937,401613,4355463,28235499,4429400,28637112
[13; 5; 7; 3; 1; 12; 9; 2; 8; 15; 4; 11; 14; 6; 10],17,79159,435190,3704415,24144401,3783574,24579591,30,73937,401613,4355463,28235499,4429400,28637112
[1; 8; 14; 6; 12; 9; 7; 5; 13; 11; 4; 15; 10; 3; 2],20,80471,443303,3767426,24522408,3847897,24965711,30,73937,401613,4355463,28235499,4429400,28637112
[2; 6; 14; 15; 5; 1; 11; 10; 7; 8; 4; 13; 3; 12; 9],18,79356,437464,3738993,24422553,3818349,24860017,30,73937,401613,4355463,28235499,4429400,28637112
[1; 12; 2; 15; 7; 8; 5; 3; 6; 10; 9; 11; 14; 4; 13],18,78625,433595,3683800,24038989,3762425,24472584,30,73937,401613,4355463,28235499,4429400,28637112
[6; 14; 10; 1; 12; 8; 5; 7; 2; 4; 11; 9; 13; 15; 3],18,80476,445277,3784093,24676109,3864569,25121386,30,73937,401613,4355463,28235499,4429400,28637112
[6; 8; 5; 3; 14; 13; 4; 7; 2; 1; 12; 9; 11; 10; 15],19,78663,432009,3736066,24370832,3814729,24802841,30,73937,401613,4355463,28235499,4429400,28637112
[1; 12; 9; 15; 11; 6; 7; 13; 8; 10; 3; 5; 14; 4; 2],18,77528,424638,3653136,23817637,3730664,24242275,30,73937,401613,4355463,28235499,4429400,28637112
[15; 3; 13; 9; 14; 8; 2; 4; 10; 11; 7; 5; 1; 6; 12],19,79604,437799,3709778,24245464,3789382,24683263,30,73937,401613,4355463,28235499,4429400,28637112
[7; 12; 11; 5; 9; 6; 2; 15; 10; 8; 13; 3; 14; 1; 4],18,80371,444902,3778147,24627065,3858518,25071967,30,73937,401613,4355463,28235499,4429400,28637112
[7; 8; 3; 12; 15; 6; 5; 11; 4; 9; 10; 13; 14; 1; 2],18,80367,445838,3697637,24125334,3778004,24571172,30,73937,401613,4355463,28235499,4429400,28637112
[12; 9; 3; 13; 11; 10; 1; 7; 2; 8; 5; 15; 14; 4; 6],20,80665,444807,3652572,23854803,3733237,24299610,30,73937,401613,4355463,28235499,4429400,28637112
[1; 8; 2; 11; 7; 12; 15; 13; 3; 14; 6; 4; 9; 5; 10],18,78697,432021,3808642,24803319,3887339,25235340,30,73937,401613,4355463,28235499,4429400,28637112
[1; 15; 14; 5; 9; 7; 12; 10; 6; 11; 13; 3; 2; 8; 4],15,76475,419002,3612260,23619121,3688735,24038123,30,73937,401613,4355463,28235499,4429400,28637112
[11; 8; 5; 1; 4; 6; 14; 7; 10; 15; 12; 13; 2; 3; 9],17,78432,430466,3775118,24603646,3853550,25034112,30,73937,401613,4355463,28235499,4429400,28637112
[12; 11; 4; 15; 10; 13; 5; 2; 6; 9; 14; 7; 8; 1; 3],18,79233,435444,3766769,24584597,3846002,25020041,30,73937,401613,4355463,28235499,4429400,28637112
[8; 9; 12; 1; 14; 6; 13; 7; 11; 15; 4; 3; 5; 10; 2],18,80202,441620,3749514,24431954,3829716,24873574,30,73937,401613,4355463,28235499,4429400,28637112
[8; 12; 10; 3; 15; 2; 4; 14; 1; 6; 13; 7; 11; 5; 9],19,77839,428027,3773069,24599237,3850908,25027264,30,73937,401613,4355463,28235499,4429400,28637112
[8; 3; 15; 5; 13; 12; 2; 6; 10; 4; 9; 1; 14; 11; 7],18,76679,420646,3733737,24351520,3810416,24772166,30,73937,401613,4355463,28235499,4429400,28637112
[4; 2; 14; 7; 8; 12; 15; 1; 13; 10; 5; 6; 9; 3; 11],18,78483,431644,3737568,24341705,3816051,24773349,30,73937,401613,4355463,28235499,4429400,28637112
[8; 15; 13; 14; 5; 3; 2; 1; 4; 9; 11; 10; 6; 7; 12],18,76370,418440,3769567,24565325,3845937,24983765,30,73937,401613,4355463,28235499,4429400,28637112
[13; 3; 8; 4; 2; 6; 7; 15; 14; 10; 12; 9; 1; 11; 5],19,79716,438653,3840865,24997735,3920581,25436388,30,73937,401613,4355463,28235499,4429400,28637112
[14; 11; 2; 4; 7; 3; 6; 15; 5; 13; 10; 1; 8; 12; 9],18,78140,429528,3816074,24839085,3894214,25268613,30,73937,401613,4355463,28235499,4429400,28637112
[12; 11; 14; 2; 5; 10; 7; 3; 13; 8; 4; 6; 1; 15; 9],18,79824,441268,3773292,24627566,3853116,25068834,30,73937,401613,4355463,28235499,4429400,28637112
[7; 4; 6; 9; 15; 8; 2; 10; 3; 12; 13; 14; 1; 5; 11],18,80446,444914,3677852,23992666,3758298,24437580,30,73937,401613,4355463,28235499,4429400,28637112
[5; 9; 6; 13; 10; 4; 7; 3; 8; 1; 14; 11; 2; 12; 15],17,77573,426002,3742473,24464911,3820046,24890913,30,73937,401613,4355463,28235499,4429400,28637112
