Learning order,PL* rounds,PL* MQ resets,PL* MQ input symbols,PL* EQ resets,PL* EQ input symbols,PL* total resets,PL* total input symbols,Non-adaptive rounds,Non-adaptive MQ resets,Non-adaptive MQ input symbols,Non-adaptive EQ resets,Non-adaptive EQ input symbols,Non-adaptive total resets,Non-adaptive total input symbols
[5; 1; 14; 6; 9; 11; 2; 15; 8; 16; 10; 3; 13; 4; 12; 7],16,704450,5295628,76108227,728029861,76812677,733325489,22,642412,4804082,82690520,786870011,83332932,791674093
[16; 14; 11; 15; 2; 13; 4; 10; 6; 3; 9; 1; 5; 12; 8; 7],16,756618,5683208,76533349,733474805,77289967,739158013,22,642412,4804082,82690520,786870011,83332932,791674093
[6; 5; 9; 1; 7; 3; 2; 15; 14; 8; 12; 16; 13; 11; 10; 4],18,681222,5098440,77124617,737866502,77805839,742964942,22,642412,4804082,82690520,786870011,83332932,791674093
[8; 2; 12; 3; 1; 11; 15; 9; 10; 4; 16; 14; 5; 6; 13; 7],16,759776,5788212,77529213,744642934,78288989,750431146,22,642412,4804082,82690520,786870011,83332932,791674093
[10; 13; 15; 5; 16; 6; 2; 14; 11; 12; 4; 7; 1; 3; 9; 8],18,818402,6104016,80839274,771178686,81657676,777282702,22,642412,4804082,82690520,786870011,83332932,791674093
[2; 11; 3; 16; 6; 9; 7; 1; 5; 13; 8; 12; 10; 4; 15; 14],16,674716,5041408,76610121,733965518,77284837,739006926,22,642412,4804082,82690520,786870011,83332932,791674093
[11; 3; 8; 15; 10; 2; 6; 9; 7; 12; 4; 1; 14; 5; 16; 13],16,780728,5918710,76354432,730853816,77135160,736772526,22,642412,4804082,82690520,786870011,83332932,791674093
[6; 1; 8; 16; 4; 13; 3; 7; 10; 5; 14; 2; 9; 12; 15; 11],18,725514,5420506,76226337,730367102,76951851,735787608,22,642412,4804082,82690520,786870011,83332932,791674093
[15; 8; 9; 3; 11; 14; 13; 4; 10; 7; 6; 5; 2; 1; 16; 12],16,768356,5751478,76327298,732225901,77095654,737977379,22,642412,4804082,82690520,786870011,83332932,791674093
[3; 8; 11; 14; 5; 15; 13; 6; 16; 12; 2; 4; 7; 10; 9; 1],16,700364,5520948,75103607,718940750,75803971,724461698,22,642412,4804082,82690520,786870011,83332932,791674093
[8; 5; 15; 14; 4; 12; 9; 11; 13; 6; 10; 7; 1; 3; 16; 2],16,736930,5541680,75670208,723817836,76407138,729359516,22,642412,4804082,82690520,786870011,83332932,791674093
[5; 16; 2; 7; 14; 6; 8; 12; 13; 9; 10; 3; 4; 1; 15; 11],16,709746,5328992,77052587,737719047,77762333,743048039,22,642412,4804082,82690520,786870011,83332932,791674093
[4; 12; 6; 14; 13; 16; 15; 8; 7; 1; 5; 10; 3; 11; 2; 9],18,753434,5839819,75571113,723188682,76324547,729028501,22,642412,4804082,82690520,786870011,83332932,791674093
[12; 13; 16; 3; 7; 15; 6; 1; 10; 9; 4; 5; 8; 11; 14; 2],16,737668,5753663,75850863,725213665,76588531,730967328,22,642412,4804082,82690520,786870011,83332932,791674093
[2; 11; 4; 3; 5; 7; 15; 13; 9; 1; 10; 8; 12; 6; 16; 14],16,760546,5793102,74816746,717147135,75577292,722940237,22,642412,4804082,82690520,786870011,83332932,791674093
[5; 6; 7; 2; 8; 11; 16; 12; 4; 1; 9; 14; 10; 15; 13; 3],18,668710,4999081,74997386,717376761,75666096,722375842,22,642412,4804082,82690520,786870011,83332932,791674093
[13; 2; 9; 7; 5; 11; 1; 3; 12; 14; 8; 6; 16; 15; 4; 10],18,726562,6057900,75894350,727124395,76620912,733182295,22,642412,4804082,82690520,786870011,83332932,791674093
[1; 4; 16; 6; 11; 12; 9; 8; 2; 15; 10; 7; 5; 14; 3; 13],18,724158,5831341,77568261,743905754,78292419,749737095,22,642412,4804082,82690520,786870011,83332932,791674093
[16; 14; 7; 13; 11; 12; 15; 2; 8; 10; 3; 6; 1; 4; 5; 9],16,769586,6000368,76277684,731100601,77047270,737100969,22,642412,4804082,82690520,786870011,83332932,791674093
[4; 2; 7; 15; 10; 14; 8; 5; 16; 11; 13; 3; 6; 12; 9; 1],16,788388,6218938,76029852,728344825,76818240,734563763,22,642412,4804082,82690520,786870011,83332932,791674093
[11; 10; 16; 13; 1; 5; 14; 4; 15; 6; 9; 3; 2; 8; 7; 12],18,788384,6042967,76246417,727615292,77034801,733658259,22,642412,4804082,82690520,786870011,83332932,791674093
[7; 3; 4; 15; 1; 11; 9; 14; 13; 5; 2; 8; 12; 16; 6; 10],18,754578,5676986,75618643,724333780,76373221,730010766,22,642412,4804082,82690520,786870011,83332932,791674093
[13; 8; 9; 10; 3; 6; 12; 14; 16; 5; 11; 15; 7; 1; 2; 4],18,810235,6259297,78386288,749722604,79196523,755981901,22,642412,4804082,82690520,786870011,83332932,791674093
[6; 9; 7; 5; 12; 4; 16; 11; 3; 10; 1; 2; 14; 8; 13; 15],18,727206,5422780,75416289,721461305,76143495,726884085,22,642412,4804082,82690520,786870011,83332932,791674093
[4; 13; 15; 6; 5; 1; 2; 11; 14; 9; 8; 3; 12; 7; 16; 10],16,741398,5742312,77072948,737947756,77814346,743690068,22,642412,4804082,82690520,786870011,83332932,791674093
[11; 10; 3; 15; 14; 16; 4; 5; 7; 9; 1; 8; 6; 2; 13; 12],18,789050,6072709,75670900,722317910,76459950,728390619,22,642412,4804082,82690520,786870011,83332932,791674093
[8; 6; 14; 4; 5; 16; 11; 9; 10; 13; 3; 7; 1; 12; 15; 2],18,733539,5663956,75855653,726339564,76589192,732003520,22,642412,4804082,82690520,786870011,83332932,791674093
[14; 11; 8; 4; 9; 12; 6; 15; 7; 13; 3; 2; 10; 16; 5; 1],16,727952,6158298,75614549,723344169,76342501,729502467,22,642412,4804082,82690520,786870011,83332932,791674093
[16; 9; 7; 1; 11; 2; 3; 8; 10; 15; 13; 6; 14; 5; 12; 4],16,747164,5821402,75562106,723882993,76309270,729704395,22,642412,4804082,82690520,786870011,83332932,791674093
[1; 11; 12; 2; 7; 9; 4; 13; 8; 3; 10; 6; 15; 5; 14; 16],16,749382,5824373,76269897,730937585,77019279,736761958,22,642412,4804082,82690520,786870011,83332932,791674093
[9; 13; 12; 10; 6; 14; 4; 16; 11; 3; 5; 2; 1; 15; 7; 8],16,813190,6248494,75911157,729080897,76724347,735329391,22,642412,4804082,82690520,786870011,83332932,791674093
[4; 12; 6; 8; 2; 10; 5; 3; 15; 9; 1; 14; 7; 16; 11; 13],18,728598,5835197,75459090,722126554,76187688,727961751,22,642412,4804082,82690520,786870011,83332932,791674093
[14; 12; 15; 6; 8; 1; 4; 7; 9; 2; 3; 5; 11; 10; 13; 16],16,742698,5723098,77099026,738600890,77841724,744323988,22,642412,4804082,82690520,786870011,83332932,791674093
[7; 14; 11; 13; 5; 8; 3; 4; 16; 10; 9; 1; 2; 12; 6; 15],18,786330,5893670,76717022,735987952,77503352,741881622,22,642412,4804082,82690520,786870011,83332932,791674093
[12; 8; 15; 9; 5; 11; 10; 16; 14; 13; 7; 3; 1; 4; 2; 6],16,775656,5995646,75454495,722561780,76230151,728557426,22,642412,4804082,82690520,786870011,83332932,791674093
[10; 14; 5; 2; 13; 4; 16; 7; 3; 11; 1; 12; 8; 9; 15; 6],18,818402,6104016,80870329,772045931,81688731,778149947,22,642412,4804082,82690520,786870011,83332932,791674093
[13; 16; 12; 2; 9; 10; 4; 5; 11; 14; 15; 7; 3; 6; 8; 1],16,789806,5983800,78173150,749778321,78962956,755762121,22,642412,4804082,82690520,786870011,83332932,791674093
[5; 11; 8; 2; 4; 7; 16; 14; 1; 12; 3; 13; 6; 15; 10; 9],16,701214,5376844,75014040,718440851,75715254,723817695,22,642412,4804082,82690520,786870011,83332932,791674093
[15; 4; 10; 3; 11; 5; 1; 16; 14; 9; 13; 2; 8; 12; 7; 6],18,799277,6175748,77176391,737896730,77975668,744072478,22,642412,4804082,82690520,786870011,83332932,791674093
[8; 2; 13; 1; 12; 6; 10; 15; 11; 4; 16; 3; 9; 5; 14; 7],16,716212,5727132,74562379,713669537,75278591,719396669,22,642412,4804082,82690520,786870011,83332932,791674093
[5; 6; 11; 16; 13; 9; 4; 3; 2; 1; 12; 14; 8; 10; 7; 15],18,694191,5441870,76393133,730373941,77087324,735815811,22,642412,4804082,82690520,786870011,83332932,791674093
[3; 9; 15; 8; 7; 2; 1; 14; 10; 16; 11; 5; 6; 4; 13; 12],16,779662,6243049,75529320,723019028,76308982,729262077,22,642412,4804082,82690520,786870011,83332932,791674093
[12; 2; 10; 7; 4; 15; 9; 13; 8; 11; 1; 5; 16; 14; 6; 3],16,797152,6289992,76655080,734381812,77452232,740671804,22,642412,4804082,82690520,786870011,83332932,791674093
[3; 10; 15; 1; 13; 4; 14; 11; 6; 5; 16; 8; 2; 12; 9; 7],18,817883,6174123,77657282,742027163,78475165,748201286,22,642412,4804082,82690520,786870011,83332932,791674093
[14; 8; 16; 3; 11; 6; 4; 9; 13; 5; 15; 7; 2; 1; 10; 12],16,713576,5653886,75862553,726242590,76576129,731896476,22,642412,4804082,82690520,786870011,83332932,791674093
[5; 6; 2; 8; 3; 11; 1; 14; 7; 12; 15; 13; 10; 9; 16; 4],18,678603,5327058,75866854,725386123,76545457,730713181,22,642412,4804082,82690520,786870011,83332932,791674093
[11; 4; 15; 12; 5; 3; 10; 14; 6; 7; 16; 8; 2; 13; 1; 9],16,781120,6195038,75000631,717729180,75781751,723924218,22,642412,4804082,82690520,786870011,83332932,791674093
[4; 5; 8; 14; 13; 9; 1; 7; 16; 2; 10; 3; 12; 11; 6; 15],16,790510,6192422,74982512,718692572,75773022,724884994,22,642412,4804082,82690520,786870011,83332932,791674093
[5; 8; 9; 13; 16; 12; 3; 1; 10; 7; 15; 4; 6; 2; 14; 11],16,790744,5932754,77354695,742994273,78145439,748927027,22,642412,4804082,82690520,786870011,83332932,791674093
[16; 8; 1; 2; 14; 13; 12; 6; 7; 15; 10; 3; 9; 11; 5; 4],16,709666,5343678,77757463,745500363,78467129,750844041,22,642412,4804082,82690520,786870011,83332932,791674093
[3; 1; 7; 6; 15; 9; 11; 10; 16; 13; 4; 14; 12; 2; 5; 8],16,712120,5694203,74337941,711111830,75050061,716806033,22,642412,4804082,82690520,786870011,83332932,791674093
[4; 9; 15; 7; 1; 14; 5; 2; 3; 10; 8; 6; 11; 16; 13; 12],16,796262,6203430,76556896,733746739,77353158,739950169,22,642412,4804082,82690520,786870011,83332932,791674093
[3; 13; 5; 12; 10; 14; 16; 7; 15; 11; 9; 2; 8; 6; 1; 4],16,814772,6296224,76861542,737006338,77676314,743302562,22,642412,4804082,82690520,786870011,83332932,791674093
[10; 15; 14; 5; 1; 2; 4; 11; 9; 6; 13; 12; 16; 3; 7; 8],18,818402,6104016,80627868,769609856,81446270,775713872,22,642412,4804082,82690520,786870011,83332932,791674093
[9; 14; 5; 13; 15; 11; 6; 4; 12; 3; 8; 16; 2; 10; 1; 7],16,715152,5801361,75690064,724779862,76405216,730581223,22,642412,4804082,82690520,786870011,83332932,791674093
[15; 9; 1; 6; 10; 7; 13; 8; 14; 2; 16; 5; 3; 12; 4; 11],16,733758,5683698,76068753,729042673,76802511,734726371,22,642412,4804082,82690520,786870011,83332932,791674093
[5; 7; 1; 12; 16; 4; 9; 6; 11; 14; 2; 15; 3; 13; 10; 8],18,748385,5774163,75038281,720391411,75786666,726165574,22,642412,4804082,82690520,786870011,83332932,791674093
[5; 4; 12; 13; 6; 16; 15; 9; 8; 14; 1; 11; 7; 10; 2; 3],16,745212,5863918,75748201,725280486,76493413,731144404,22,642412,4804082,82690520,786870011,83332932,791674093
[5; 2; 11; 4; 7; 9; 14; 6; 13; 1; 12; 10; 3; 16; 8; 15],16,708756,5443260,77752071,746400212,78460827,751843472,22,642412,4804082,82690520,786870011,83332932,791674093
[16; 4; 3; 6; 14; 2; 11; 8; 7; 12; 5; 10; 13; 1; 9; 15],16,734558,5701822,77232497,740599691,77967055,746301513,22,642412,4804082,82690520,786870011,83332932,791674093
[15; 8; 10; 16; 11; 6; 7; 13; 12; 14; 3; 5; 9; 4; 2; 1],16,798258,5993490,78128061,750855917,78926319,756849407,22,642412,4804082,82690520,786870011,83332932,791674093
[15; 16; 14; 13; 1; 3; 9; 12; 5; 4; 8; 11; 10; 7; 2; 6],16,781888,5838110,77479427,743889663,78261315,749727773,22,642412,4804082,82690520,786870011,83332932,791674093
[7; 16; 2; 15; 11; 3; 6; 12; 13; 10; 14; 9; 8; 1; 4; 5],18,681726,5092624,76646844,733724899,77328570,738817523,22,642412,4804082,82690520,786870011,83332932,791674093
[3; 16; 2; 1; 6; 11; 14; 5; 4; 13; 7; 12; 8; 10; 9; 15],16,694642,5859946,76213275,729764199,76907917,735624145,22,642412,4804082,82690520,786870011,83332932,791674093
[10; 9; 5; 3; 13; 15; 14; 11; 4; 2; 16; 12; 7; 6; 1; 8],18,818402,6104016,80812505,771307972,81630907,777411988,22,642412,4804082,82690520,786870011,83332932,791674093
[9; 4; 14; 6; 8; 11; 15; 2; 1; 13; 7; 12; 16; 10; 3; 5],16,753610,5697738,76645389,734558642,77398999,740256380,22,642412,4804082,82690520,786870011,83332932,791674093
[8; 11; 6; 9; 2; 16; 4; 3; 10; 5; 14; 12; 15; 13; 7; 1],16,679672,5326654,75522510,723465108,76202182,728791762,22,642412,4804082,82690520,786870011,83332932,791674093
[14; 9; 15; 7; 11; 5; 2; 4; 16; 10; 6; 3; 8; 13; 1; 12],16,769562,5845058,75350827,722029437,76120389,727874495,22,642412,4804082,82690520,786870011,83332932,791674093
[4; 8; 14; 11; 7; 15; 1; 5; 6; 13; 10; 16; 9; 3; 2; 12],16,747492,5997932,75803034,725836230,76550526,731834162,22,642412,4804082,82690520,786870011,83332932,791674093
[16; 4; 6; 9; 1; 14; 3; 2; 7; 12; 15; 8; 11; 5; 13; 10],18,731026,5710491,77029509,738424126,77760535,744134617,22,642412,4804082,82690520,786870011,83332932,791674093
[8; 15; 5; 1; 7; 11; 4; 14; 10; 9; 12; 13; 3; 6; 16; 2],16,763716,5734844,74328685,711797767,75092401,717532611,22,642412,4804082,82690520,786870011,83332932,791674093
[1; 11; 12; 8; 10; 14; 5; 16; 6; 3; 9; 2; 13; 15; 4; 7],16,781876,6070216,75937677,729173942,76719553,735244158,22,642412,4804082,82690520,786870011,83332932,791674093
[1; 5; 15; 12; 14; 10; 8; 9; 16; 13; 6; 11; 4; 2; 7; 3],16,802818,6227382,77069839,739506352,77872657,745733734,22,642412,4804082,82690520,786870011,83332932,791674093
[4; 11; 14; 13; 5; 9; 6; 7; 8; 12; 10; 1; 2; 16; 15; 3],16,755668,5829138,75914525,726629763,76670193,732458901,22,642412,4804082,82690520,786870011,83332932,791674093
[13; 8; 12; 16; 2; 1; 5; 10; 7; 6; 15; 14; 3; 9; 11; 4],16,782386,6306540,76654556,734678145,77436942,740984685,22,642412,4804082,82690520,786870011,83332932,791674093
[6; 14; 11; 3; 4; 7; 10; 16; 9; 12; 13; 2; 5; 1; 15; 8],18,720054,5377330,75683249,723971084,76403303,729348414,22,642412,4804082,82690520,786870011,83332932,791674093
[16; 7; 9; 1; 5; 4; 8; 13; 6; 10; 15; 11; 3; 12; 14; 2],18,727646,5689916,75159613,720500460,75887259,726190376,22,642412,4804082,82690520,786870011,83332932,791674093
[11; 1; 15; 2; 16; 7; 10; 13; 9; 14; 4; 6; 12; 5; 3; 8],16,742462,5718014,76064066,729170511,76806528,734888525,22,642412,4804082,82690520,786870011,83332932,791674093
[8; 10; 6; 11; 4; 14; 5; 2; 3; 12; 16; 15; 1; 7; 13; 9],18,809823,6106835,77633329,742885502,78443152,748992337,22,642412,4804082,82690520,786870011,83332932,791674093
[2; 11; 12; 3; 16; 6; 10; 5; 14; 8; 1; 7; 15; 9; 4; 13],16,695782,5201240,75878502,726709302,76574284,731910542,22,642412,4804082,82690520,786870011,83332932,791674093
[16; 5; 6; 7; 1; 15; 4; 3; 12; 13; 2; 11; 14; 10; 9; 8],16,698280,5409618,75709899,725243383,76408179,730653001,22,642412,4804082,82690520,786870011,83332932,791674093
[2; 3; 16; 4; 7; 9; 5; 12; 14; 8; 13; 1; 15; 6; 10; 11],16,731036,6095286,74632305,715175812,75363341,721271098,22,642412,4804082,82690520,786870011,83332932,791674093
[11; 6; 9; 7; 2; 12; 10; 3; 14; 5; 4; 13; 8; 16; 15; 1],18,686527,5232385,75837597,725895183,76524124,731127568,22,642412,4804082,82690520,786870011,83332932,791674093
[7; 16; 14; 15; 8; 13; 2; 11; 6; 3; 10; 1; 4; 5; 9; 12],18,706638,5298660,76075018,728806798,76781656,734105458,22,642412,4804082,82690520,786870011,83332932,791674093
[4; 15; 12; 1; 10; 13; 8; 9; 14; 7; 16; 11; 5; 2; 6; 3],18,810141,6172422,77072381,735556752,77882522,741729174,22,642412,4804082,82690520,786870011,83332932,791674093
[2; 15; 8; 3; 6; 9; 4; 1; 10; 11; 5; 16; 12; 14; 7; 13],16,711212,5384910,77211518,740413735,77922730,745798645,22,642412,4804082,82690520,786870011,83332932,791674093
[6; 2; 12; 11; 8; 9; 16; 15; 5; 10; 4; 14; 13; 1; 3; 7],18,684626,5109678,75979545,726725602,76664171,731835280,22,642412,4804082,82690520,786870011,83332932,791674093
[15; 9; 14; 16; 1; 10; 7; 5; 13; 4; 6; 8; 3; 11; 2; 12],16,797754,6196476,76145098,729265295,76942852,735461771,22,642412,4804082,82690520,786870011,83332932,791674093
[16; 4; 8; 6; 1; 14; 11; 10; 9; 2; 3; 15; 12; 13; 7; 5],16,736186,5939820,75304332,721519987,76040518,727459807,22,642412,4804082,82690520,786870011,83332932,791674093
[14; 8; 16; 10; 9; 6; 7; 4; 1; 2; 15; 3; 13; 12; 5; 11],16,805078,6043050,79882406,767659489,80687484,773702539,22,642412,4804082,82690520,786870011,83332932,791674093
[12; 16; 2; 10; 6; 4; 1; 14; 11; 13; 8; 5; 15; 9; 3; 7],16,789354,6117428,75711475,725179010,76500829,731296438,22,642412,4804082,82690520,786870011,83332932,791674093
[10; 12; 11; 8; 6; 15; 16; 13; 4; 3; 14; 5; 9; 7; 2; 1],18,818402,6104016,81161579,774337525,81979981,780441541,22,642412,4804082,82690520,786870011,83332932,791674093
[15; 9; 14; 2; 10; 6; 13; 3; 4; 7; 8; 16; 5; 11; 12; 1],16,795392,6231976,78779442,755559622,79574834,761791598,22,642412,4804082,82690520,786870011,83332932,791674093
[13; 15; 12; 5; 4; 9; 1; 14; 6; 7; 11; 2; 16; 8; 3; 10],16,748824,5812390,76334223,731754567,77083047,737566957,22,642412,4804082,82690520,786870011,83332932,791674093
[7; 13; 9; 5; 2; 15; 14; 6; 11; 12; 1; 3; 10; 16; 4; 8],18,708990,5375785,75950026,727087648,76659016,732463433,22,642412,4804082,82690520,786870011,83332932,791674093
[5; 10; 16; 1; 13; 14; 11; 9; 8; 15; 7; 6; 2; 3; 12; 4],18,813411,6127341,77626891,742290679,78440302,748418020,22,642412,4804082,82690520,786870011,83332932,791674093
[5; 7; 16; 8; 14; 3; 6; 10; 11; 9; 1; 4; 12; 15; 2; 13],18,746990,5720658,75306241,720445696,76053231,726166354,22,642412,4804082,82690520,786870011,83332932,791674093
[6; 3; 14; 5; 13; 8; 9; 1; 12; 10; 2; 16; 7; 4; 15; 11],18,740098,5515432,76749546,733789401,77489644,739304833,22,642412,4804082,82690520,786870011,83332932,791674093
[16; 5; 11; 15; 3; 6; 8; 9; 4; 12; 7; 13; 1; 14; 2; 10],16,687838,5389304,76082825,728509180,76770663,733898484,22,642412,4804082,82690520,786870011,83332932,791674093
[2; 15; 12; 8; 1; 16; 9; 13; 6; 5; 11; 4; 14; 7; 10; 3],16,686652,5520746,77913392,747521034,78600044,753041780,22,642412,4804082,82690520,786870011,83332932,791674093
[5; 12; 13; 8; 6; 7; 16; 1; 14; 2; 11; 4; 15; 9; 3; 10],16,706120,5453490,75913396,727712172,76619516,733165662,22,642412,4804082,82690520,786870011,83332932,791674093
[6; 3; 10; 9; 4; 14; 2; 5; 16; 11; 7; 8; 15; 12; 1; 13],18,743558,5543426,74924187,716487002,75667745,722030428,22,642412,4804082,82690520,786870011,83332932,791674093
[8; 15; 9; 3; 6; 11; 14; 7; 4; 1; 13; 2; 16; 12; 5; 10],16,695636,5232254,76820371,736606102,77516007,741838356,22,642412,4804082,82690520,786870011,83332932,791674093
[6; 9; 14; 15; 4; 10; 1; 5; 2; 16; 7; 12; 13; 8; 11; 3],18,737678,5486192,76962877,736817655,77700555,742303847,22,642412,4804082,82690520,786870011,83332932,791674093
[3; 13; 12; 15; 9; 2; 8; 14; 4; 10; 1; 11; 16; 7; 5; 6],16,782466,6079994,75577728,724628247,76360194,730708241,22,642412,4804082,82690520,786870011,83332932,791674093
[8; 12; 9; 10; 11; 1; 13; 7; 15; 2; 14; 4; 3; 6; 16; 5],16,808080,6067301,74557099,715262165,75365179,721329466,22,642412,4804082,82690520,786870011,83332932,791674093
[4; 10; 3; 1; 12; 2; 5; 8; 7; 14; 15; 16; 9; 6; 13; 11],18,810860,6267882,76315554,730991689,77126414,737259571,22,642412,4804082,82690520,786870011,83332932,791674093
[2; 8; 16; 7; 5; 9; 12; 14; 6; 1; 10; 13; 4; 11; 15; 3],16,704058,5584878,75930166,727493123,76634224,733078001,22,642412,4804082,82690520,786870011,83332932,791674093
[15; 8; 1; 12; 11; 5; 7; 2; 3; 14; 9; 13; 6; 10; 4; 16],16,690900,5247598,77413323,742055400,78104223,747302998,22,642412,4804082,82690520,786870011,83332932,791674093
[8; 2; 13; 6; 5; 14; 7; 1; 12; 4; 9; 15; 10; 11; 3; 16],18,710243,5709775,76649483,733968287,77359726,739678062,22,642412,4804082,82690520,786870011,83332932,791674093
[4; 2; 7; 12; 9; 16; 10; 5; 6; 11; 15; 8; 13; 1; 3; 14],16,787518,6172309,75572604,724593745,76360122,730766054,22,642412,4804082,82690520,786870011,83332932,791674093
[12; 4; 8; 2; 9; 11; 7; 6; 1; 13; 15; 5; 16; 14; 10; 3],16,714916,5359850,76366847,732179689,77081763,737539539,22,642412,4804082,82690520,786870011,83332932,791674093
[7; 4; 5; 11; 15; 10; 1; 16; 8; 3; 9; 2; 14; 13; 12; 6],18,805050,6031656,74933375,717756840,75738425,723788496,22,642412,4804082,82690520,786870011,83332932,791674093
[2; 3; 13; 8; 11; 5; 9; 15; 16; 4; 1; 12; 7; 14; 6; 10],16,694628,5349334,75666936,724993969,76361564,730343303,22,642412,4804082,82690520,786870011,83332932,791674093
[10; 5; 16; 7; 12; 3; 8; 9; 14; 4; 6; 11; 15; 13; 1; 2],18,818402,6104016,80766676,770875351,81585078,776979367,22,642412,4804082,82690520,786870011,83332932,791674093
[1; 15; 4; 5; 6; 10; 3; 7; 12; 16; 2; 11; 9; 8; 13; 14],16,741582,5829611,75524203,724822930,76265785,730652541,22,642412,4804082,82690520,786870011,83332932,791674093
[12; 14; 3; 7; 8; 15; 4; 16; 5; 10; 11; 6; 1; 2; 13; 9],16,806046,6170780,76305737,731055111,77111783,737225891,22,642412,4804082,82690520,786870011,83332932,791674093
[6; 1; 12; 16; 7; 15; 14; 11; 4; 13; 5; 10; 3; 9; 2; 8],18,707814,5280642,76958194,735887245,77666008,741167887,22,642412,4804082,82690520,786870011,83332932,791674093
[7; 3; 2; 1; 11; 10; 5; 6; 9; 8; 4; 15; 12; 13; 14; 16],18,765560,5754127,76460483,733363464,77226043,739117591,22,642412,4804082,82690520,786870011,83332932,791674093
[14; 11; 6; 2; 12; 8; 15; 16; 10; 1; 13; 4; 9; 3; 7; 5],16,712464,5653188,75502927,722337598,76215391,727990786,22,642412,4804082,82690520,786870011,83332932,791674093
[6; 7; 2; 10; 13; 11; 15; 8; 14; 4; 9; 5; 12; 1; 16; 3],18,713646,5319358,76311239,729267539,77024885,734586897,22,642412,4804082,82690520,786870011,83332932,791674093
[5; 1; 16; 10; 8; 12; 9; 15; 6; 3; 2; 13; 14; 4; 7; 11],16,800438,6011956,73458870,704630560,74259308,710642516,22,642412,4804082,82690520,786870011,83332932,791674093
[5; 11; 2; 1; 8; 14; 15; 4; 12; 10; 13; 9; 3; 16; 7; 6],16,741934,5741676,76734259,736231958,77476193,741973634,22,642412,4804082,82690520,786870011,83332932,791674093
[11; 8; 14; 5; 10; 4; 3; 7; 6; 12; 13; 2; 15; 16; 9; 1],16,779100,5856994,79144302,761001958,79923402,766858952,22,642412,4804082,82690520,786870011,83332932,791674093
[16; 6; 7; 4; 9; 11; 5; 1; 14; 12; 8; 10; 13; 3; 2; 15],18,719182,5395643,76450163,733169773,77169345,738565416,22,642412,4804082,82690520,786870011,83332932,791674093
[14; 12; 11; 16; 10; 2; 9; 6; 15; 1; 13; 7; 5; 8; 3; 4],16,786124,6297726,76757672,736287205,77543796,742584931,22,642412,4804082,82690520,786870011,83332932,791674093
[8; 13; 14; 3; 7; 16; 6; 5; 15; 10; 9; 2; 11; 1; 12; 4],18,754308,5784495,77918657,748379261,78672965,754163756,22,642412,4804082,82690520,786870011,83332932,791674093
[12; 13; 3; 10; 4; 2; 8; 16; 9; 15; 1; 11; 7; 6; 5; 14],16,816022,6356122,77221173,739324571,78037195,745680693,22,642412,4804082,82690520,786870011,83332932,791674093
[16; 11; 7; 5; 3; 15; 10; 4; 1; 9; 2; 14; 12; 8; 13; 6],18,763743,5711291,74719605,714645736,75483348,720357027,22,642412,4804082,82690520,786870011,83332932,791674093
[15; 7; 5; 4; 10; 11; 6; 12; 2; 3; 8; 16; 1; 9; 14; 13],18,797801,6061368,74479258,713231345,75277059,719292713,22,642412,4804082,82690520,786870011,83332932,791674093
[5; 8; 10; 12; 4; 1; 13; 16; 15; 2; 7; 14; 6; 9; 3; 11],18,804829,6273746,77651740,743330003,78456569,749603749,22,642412,4804082,82690520,786870011,83332932,791674093
[6; 1; 12; 16; 7; 4; 8; 10; 13; 3; 2; 11; 5; 9; 15; 14],18,722118,5403372,77807673,744835331,78529791,750238703,22,642412,4804082,82690520,786870011,83332932,791674093
[8; 2; 12; 11; 3; 10; 13; 16; 7; 14; 6; 15; 4; 9; 1; 5],16,762976,5834286,76516736,732444203,77279712,738278489,22,642412,4804082,82690520,786870011,83332932,791674093
[8; 10; 12; 2; 5; 3; 6; 13; 4; 16; 9; 15; 7; 1; 14; 11],18,809823,6392468,78236074,749469116,79045897,755861584,22,642412,4804082,82690520,786870011,83332932,791674093
[10; 14; 1; 2; 12; 9; 5; 15; 16; 11; 13; 4; 3; 8; 7; 6],18,818402,6104016,81069162,773096625,81887564,779200641,22,642412,4804082,82690520,786870011,83332932,791674093
[13; 6; 3; 9; 11; 7; 12; 16; 8; 4; 5; 1; 14; 10; 15; 2],18,710751,5666513,75851939,726310585,76562690,731977098,22,642412,4804082,82690520,786870011,83332932,791674093
[2; 12; 9; 4; 10; 13; 7; 1; 3; 8; 5; 6; 11; 15; 14; 16],16,789028,5904736,76406833,733516944,77195861,739421680,22,642412,4804082,82690520,786870011,83332932,791674093
[12; 16; 5; 8; 14; 3; 7; 2; 4; 6; 9; 1; 15; 10; 11; 13],16,733752,5627966,75805247,726219771,76538999,731847737,22,642412,4804082,82690520,786870011,83332932,791674093
[9; 8; 10; 12; 7; 14; 1; 6; 4; 5; 2; 16; 15; 3; 13; 11],18,807981,6232350,76774023,733553768,77582004,739786118,22,642412,4804082,82690520,786870011,83332932,791674093
[4; 13; 1; 5; 12; 9; 10; 16; 8; 7; 3; 15; 6; 14; 11; 2],16,808768,6188302,75474542,723210172,76283310,729398474,22,642412,4804082,82690520,786870011,83332932,791674093
[11; 6; 13; 8; 15; 14; 5; 16; 9; 7; 10; 4; 2; 1; 12; 3],18,696743,5320603,74470245,712018822,75166988,717339425,22,642412,4804082,82690520,786870011,83332932,791674093
[7; 2; 16; 3; 8; 12; 14; 6; 13; 9; 5; 4; 11; 15; 10; 1],18,717306,5389398,75327279,720890315,76044585,726279713,22,642412,4804082,82690520,786870011,83332932,791674093
[13; 12; 3; 10; 5; 6; 11; 16; 9; 7; 4; 1; 2; 15; 8; 14],16,814510,6262458,75793738,726470298,76608248,732732756,22,642412,4804082,82690520,786870011,83332932,791674093
[2; 3; 7; 10; 13; 12; 8; 11; 6; 14; 9; 5; 4; 1; 16; 15],18,785651,6084791,74487588,713721384,75273239,719806175,22,642412,4804082,82690520,786870011,83332932,791674093
[13; 10; 14; 15; 2; 4; 11; 7; 12; 3; 5; 6; 8; 16; 1; 9],18,817155,6252118,78137292,747466308,78954447,753718426,22,642412,4804082,82690520,786870011,83332932,791674093
[10; 2; 7; 8; 3; 11; 6; 4; 14; 9; 12; 16; 15; 1; 13; 5],18,818402,6104016,80667990,770070353,81486392,776174369,22,642412,4804082,82690520,786870011,83332932,791674093
[10; 2; 16; 9; 5; 1; 15; 3; 8; 6; 14; 7; 4; 13; 12; 11],18,818402,6104016,80725290,770702652,81543692,776806668,22,642412,4804082,82690520,786870011,83332932,791674093
[4; 12; 14; 10; 11; 2; 8; 1; 16; 3; 15; 9; 5; 13; 7; 6],16,810362,6266560,75473134,722986098,76283496,729252658,22,642412,4804082,82690520,786870011,83332932,791674093
[2; 4; 14; 7; 9; 10; 13; 6; 8; 5; 1; 15; 12; 11; 3; 16],16,787098,6191128,75796364,726802050,76583462,732993178,22,642412,4804082,82690520,786870011,83332932,791674093
[10; 13; 8; 3; 16; 6; 11; 2; 1; 9; 14; 4; 7; 12; 5; 15],18,818402,6104016,80447469,767953699,81265871,774057715,22,642412,4804082,82690520,786870011,83332932,791674093
[10; 16; 14; 11; 1; 8; 12; 3; 5; 7; 15; 4; 9; 13; 6; 2],18,818402,6104016,80694916,770391643,81513318,776495659,22,642412,4804082,82690520,786870011,83332932,791674093
[13; 15; 8; 14; 7; 12; 4; 6; 3; 10; 1; 16; 11; 5; 2; 9],16,752524,5757082,77341107,741315200,78093631,747072282,22,642412,4804082,82690520,786870011,83332932,791674093
[3; 7; 16; 12; 9; 13; 15; 10; 6; 4; 2; 5; 14; 8; 1; 11],18,807513,6450743,76523478,733434415,77330991,739885158,22,642412,4804082,82690520,786870011,83332932,791674093
[1; 8; 7; 13; 3; 10; 4; 5; 12; 14; 15; 9; 11; 16; 6; 2],16,797200,6192540,77672835,745779660,78470035,751972200,22,642412,4804082,82690520,786870011,83332932,791674093
[3; 2; 13; 14; 9; 15; 8; 12; 4; 7; 16; 5; 6; 11; 1; 10],16,735522,5598506,75637391,724673521,76372913,730272027,22,642412,4804082,82690520,786870011,83332932,791674093
[14; 7; 2; 3; 4; 8; 12; 16; 6; 10; 1; 15; 5; 9; 13; 11],18,771373,6560651,77846522,746464683,78617895,753025334,22,642412,4804082,82690520,786870011,83332932,791674093
[14; 4; 6; 16; 1; 11; 8; 13; 10; 5; 7; 12; 9; 2; 3; 15],16,764092,5869820,76016895,728049229,76780987,733919049,22,642412,4804082,82690520,786870011,83332932,791674093
[12; 13; 4; 1; 15; 9; 14; 5; 16; 10; 8; 11; 3; 6; 2; 7],16,802954,6114846,76664261,734061615,77467215,740176461,22,642412,4804082,82690520,786870011,83332932,791674093
[3; 1; 10; 5; 13; 7; 8; 2; 6; 16; 15; 4; 11; 14; 12; 9],16,816172,6909956,77309658,741735704,78125830,748645660,22,642412,4804082,82690520,786870011,83332932,791674093
[13; 11; 9; 10; 15; 7; 2; 1; 5; 6; 14; 12; 3; 8; 4; 16],16,787962,6032908,75520510,724730404,76308472,730763312,22,642412,4804082,82690520,786870011,83332932,791674093
[6; 13; 10; 11; 9; 2; 12; 5; 7; 3; 14; 4; 15; 1; 16; 8],18,743558,5522818,75701961,723288936,76445519,728811754,22,642412,4804082,82690520,786870011,83332932,791674093
[13; 6; 9; 15; 2; 3; 5; 16; 1; 14; 10; 11; 7; 12; 4; 8],18,721083,5776136,75289953,720588210,76011036,726364346,22,642412,4804082,82690520,786870011,83332932,791674093
[7; 3; 11; 12; 4; 6; 5; 10; 15; 14; 2; 13; 1; 16; 9; 8],18,726602,5516868,74435505,713293694,75162107,718810562,22,642412,4804082,82690520,786870011,83332932,791674093
[7; 5; 1; 2; 14; 16; 12; 8; 4; 9; 3; 10; 6; 15; 13; 11],18,774446,5844426,78797602,755632613,79572048,761477039,22,642412,4804082,82690520,786870011,83332932,791674093
[13; 10; 12; 14; 4; 9; 2; 3; 8; 15; 5; 16; 11; 6; 7; 1],18,817155,6397610,78374079,749176700,79191234,755574310,22,642412,4804082,82690520,786870011,83332932,791674093
[2; 11; 9; 5; 12; 7; 10; 14; 8; 1; 16; 15; 3; 4; 13; 6],16,756294,5952340,75808514,727455077,76564808,733407417,22,642412,4804082,82690520,786870011,83332932,791674093
[9; 6; 14; 16; 7; 1; 11; 4; 12; 3; 10; 8; 5; 13; 2; 15],18,703298,5258099,78702803,755243980,79406101,760502079,22,642412,4804082,82690520,786870011,83332932,791674093
[2; 7; 8; 15; 5; 13; 6; 11; 3; 12; 16; 1; 4; 9; 14; 10],18,693466,5325448,75108378,719415594,75801844,724741042,22,642412,4804082,82690520,786870011,83332932,791674093
[10; 9; 4; 15; 14; 1; 6; 7; 12; 11; 2; 13; 16; 8; 3; 5],18,818402,6104016,80502410,768889999,81320812,774994015,22,642412,4804082,82690520,786870011,83332932,791674093
[15; 4; 12; 6; 5; 16; 7; 14; 11; 13; 10; 9; 8; 3; 2; 1],18,740934,5619069,78196479,750006085,78937413,755625154,22,642412,4804082,82690520,786870011,83332932,791674093
[7; 5; 4; 9; 3; 2; 11; 1; 14; 10; 8; 15; 6; 12; 16; 13],18,787450,5971126,76508069,733821425,77295519,739792551,22,642412,4804082,82690520,786870011,83332932,791674093
[5; 16; 11; 15; 7; 3; 8; 10; 2; 4; 1; 6; 14; 12; 9; 13],16,756580,5973334,77149037,740969351,77905617,746942685,22,642412,4804082,82690520,786870011,83332932,791674093
[12; 2; 1; 16; 15; 13; 10; 3; 8; 5; 6; 9; 11; 4; 7; 14],16,783498,5974528,75610660,725138203,76394158,731112731,22,642412,4804082,82690520,786870011,83332932,791674093
[4; 13; 1; 9; 7; 2; 10; 6; 3; 12; 11; 5; 15; 8; 14; 16],16,791120,6066180,76312882,731355646,77104002,737421826,22,642412,4804082,82690520,786870011,83332932,791674093
[7; 16; 13; 14; 3; 5; 6; 1; 8; 15; 2; 11; 4; 9; 12; 10],18,706058,5268824,75765833,725453491,76471891,730722315,22,642412,4804082,82690520,786870011,83332932,791674093
[7; 15; 12; 1; 10; 4; 8; 16; 11; 13; 14; 2; 3; 6; 5; 9],18,802890,6012402,74559488,715028593,75362378,721040995,22,642412,4804082,82690520,786870011,83332932,791674093
[15; 8; 11; 7; 4; 13; 5; 9; 6; 14; 3; 2; 16; 12; 1; 10],16,705546,5309450,75476246,723740477,76181792,729049927,22,642412,4804082,82690520,786870011,83332932,791674093
[4; 6; 16; 12; 2; 11; 15; 3; 14; 8; 1; 7; 13; 10; 5; 9],18,734850,5599960,75637368,724717380,76372218,730317340,22,642412,4804082,82690520,786870011,83332932,791674093
[2; 14; 12; 10; 8; 1; 7; 15; 11; 16; 13; 9; 3; 6; 5; 4],16,793802,6076744,76066334,728991800,76860136,735068544,22,642412,4804082,82690520,786870011,83332932,791674093
[2; 4; 10; 15; 1; 5; 13; 9; 11; 7; 14; 6; 3; 12; 16; 8],16,791032,6023814,76840842,737775660,77631874,743799474,22,642412,4804082,82690520,786870011,83332932,791674093
[14; 7; 15; 5; 12; 3; 2; 9; 8; 11; 16; 13; 6; 1; 10; 4],18,727717,5931272,75676595,723721077,76404312,729652349,22,642412,4804082,82690520,786870011,83332932,791674093
[14; 6; 9; 15; 3; 10; 1; 4; 8; 2; 7; 13; 5; 11; 16; 12],18,748453,5964958,74862735,715526100,75611188,721491058,22,642412,4804082,82690520,786870011,83332932,791674093
[7; 1; 8; 3; 13; 16; 11; 12; 6; 5; 15; 4; 2; 14; 10; 9],18,688910,5170688,75479631,722703209,76168541,727873897,22,642412,4804082,82690520,786870011,83332932,791674093
[15; 6; 2; 7; 1; 8; 4; 13; 5; 12; 10; 3; 16; 14; 9; 11],18,698530,5216505,76162747,728894238,76861277,734110743,22,642412,4804082,82690520,786870011,83332932,791674093
[14; 2; 7; 16; 15; 9; 5; 13; 8; 11; 12; 6; 10; 1; 3; 4],18,720806,6050870,77240897,740818086,77961703,746868956,22,642412,4804082,82690520,786870011,83332932,791674093
[8; 4; 1; 14; 7; 10; 15; 13; 2; 11; 12; 3; 9; 6; 16; 5],16,799876,6002316,76256172,730778405,77056048,736780721,22,642412,4804082,82690520,786870011,83332932,791674093
[16; 3; 4; 11; 13; 7; 5; 8; 10; 1; 15; 9; 6; 2; 14; 12],16,790842,5941096,75688080,725218763,76478922,731159859,22,642412,4804082,82690520,786870011,83332932,791674093
[12; 4; 10; 5; 6; 8; 2; 15; 3; 11; 1; 16; 7; 9; 14; 13],18,814477,6311971,76815083,734762350,77629560,741074321,22,642412,4804082,82690520,786870011,83332932,791674093
[10; 4; 13; 16; 2; 12; 14; 8; 11; 9; 5; 7; 1; 15; 6; 3],18,818402,6104016,81045212,773640223,81863614,779744239,22,642412,4804082,82690520,786870011,83332932,791674093
[9; 11; 14; 4; 16; 2; 15; 3; 13; 6; 5; 8; 7; 1; 10; 12],16,718770,5680080,75724080,725352595,76442850,731032675,22,642412,4804082,82690520,786870011,83332932,791674093
[12; 4; 11; 2; 5; 8; 16; 14; 1; 6; 13; 10; 15; 3; 7; 9],16,723502,5521786,76931577,736672888,77655079,742194674,22,642412,4804082,82690520,786870011,83332932,791674093
[11; 14; 2; 8; 1; 4; 7; 15; 9; 16; 13; 5; 6; 12; 10; 3],16,719572,5394722,75526213,724474983,76245785,729869705,22,642412,4804082,82690520,786870011,83332932,791674093
[9; 6; 10; 5; 7; 12; 3; 16; 8; 11; 1; 13; 2; 15; 14; 4],18,741719,5798056,73655134,704192927,74396853,709990983,22,642412,4804082,82690520,786870011,83332932,791674093
[10; 11; 3; 12; 16; 4; 6; 14; 2; 13; 5; 1; 8; 9; 15; 7],18,818402,6104016,80572162,769243574,81390564,775347590,22,642412,4804082,82690520,786870011,83332932,791674093
[13; 16; 15; 1; 4; 7; 9; 11; 6; 8; 2; 12; 5; 14; 3; 10],16,722326,6076074,75182116,720284628,75904442,726360702,22,642412,4804082,82690520,786870011,83332932,791674093
[6; 11; 4; 14; 16; 13; 12; 5; 2; 7; 15; 3; 1; 9; 8; 10],18,714398,5321530,76974488,735946851,77688886,741268381,22,642412,4804082,82690520,786870011,83332932,791674093
[10; 4; 12; 7; 14; 9; 8; 1; 2; 16; 5; 6; 15; 3; 13; 11],18,818402,6104016,80537492,768678832,81355894,774782848,22,642412,4804082,82690520,786870011,83332932,791674093
[2; 8; 11; 4; 9; 13; 14; 3; 7; 15; 5; 10; 1; 12; 16; 6],16,751684,5800330,75948054,728228939,76699738,734029269,22,642412,4804082,82690520,786870011,83332932,791674093
[4; 8; 10; 12; 2; 7; 1; 13; 14; 5; 16; 11; 6; 3; 15; 9],16,805140,6257632,75585098,725075933,76390238,731333565,22,642412,4804082,82690520,786870011,83332932,791674093
[9; 10; 6; 3; 1; 7; 15; 4; 11; 2; 14; 16; 8; 5; 13; 12],18,816563,6165011,76324403,729838253,77140966,736003264,22,642412,4804082,82690520,786870011,83332932,791674093
